name Very Small Labyrinth of Dooom
win 2
###################
#.........#.......#
#......G..#.....E.#
#####.....#..######
#..E#.............#
#...#......G..#...#
#..##..########...#
#......#..........#
###################