###################
#.................#
#......G........E.#
#.................#
#..E..............#
#..........G......#
#.................#
#.................#
###################
$
0 3 15 0 0 0 0 
1 -42 -42 0 0 0 0 
2 -42 -42 0 0 0 0 
3 -42 -42 0 0 0 0 
4 -42 -42 0 0 0 0 
5 -42 -42 0 0 0 0 
6 -42 -42 0 0 0 0 
7 -42 -42 0 0 0 0 
8 -42 -42 0 0 0 0 
9 -42 -42 0 0 0 0 
10 -42 -42 0 0 0 0 
11 -42 -42 0 0 0 0 
12 -42 -42 0 0 0 0 
13 -42 -42 0 0 0 0 
14 -42 -42 0 0 0 0 
15 -42 -42 0 0 0 0 
16 -42 -42 0 0 0 0 
17 -42 -42 0 0 0 0 
18 -42 -42 0 0 0 0 
19 -42 -42 0 0 0 0 
name Very Small Labyrinth of Dooom
win 2
